1111111111111
0000000000001
1111111111101
1000000000101
1011111110101
1010000010101
1010111110101
1010100000101
1010111111101
1010000000001
1011111111111
1000000000000
1111111111111
