100011111
100010001
100010001
100010001
100010001
100010001
100010001
100010001
111110001
