111111111
000000001
000000111
000001100
000011000
000110000
111100000
100000000
111111111
