111111111
000000001
111100001
100110001
100011001
100001101
100000111
100000000
111111111
