100000111
100000101
100000101
100000101
100001101
100011001
100110001
101100001
111000001
