111110000
000010000
111110000
100000000
111110000
000010000
111110000
100000000
111111111
