101110111
101010101
101010101
101010101
111011101
000000001
000000001
000000001
000000001
