1111111
1001000
1011100
1110111
1011101
1000001
1000001
