1110111
1010101
1011101
1000001
1000001
1000001
1111111
