1111110
1111111
1111011
1110111
1101111
1011111
0111111
