1111111
1000001
1110001
0010001
1110001
1000001
1111111
